222222222222222222222222-
211111111111111111111112-
211111111111111111111112-
222222222111111111111112-
211111111111111111222222-
211111111111111111111112-
211111222221111111111112-
211111111111111111111112-
222222222222222222222222